21 7
#--------|@|--------#
|                   |
| [R]               |
| [F]              o|
|           &       |
|[p] [H] [Q] [S] [P]|
#-------------------#
