21 6
#--------|@|--------#
| [R]               |
| [F]              o|
|           &       |
|[p] [H] [Q] [S] [P]|
#-------------------#
