21 8
#--------|@|--------#
|                   |
| [R]               |
|                   |
| [F]              o|
|           &       |
|[p] [H] [Q] [S] [P]|
#-------------------#
